



F 100,1,110   


C 255,255,255










WE testEA
SO testSO
EA testWE




NO testNO
                                  
11111111111111111
10010100W00000001
10100100000000001
1111111111111111
111111           


