F 100,1,110   

C                    255 ,            255           ,            255


WE testEA
SO testSO


NO testNO
EA testWE




111111111111
111100001111
1000001
1000001
1000001111
100N000001
1111111111