F 100,1,110   

C                    255 ,            255           ,            255

WE testEA
SO testSO


NO testNO
EA testWE




11111111111111111
         10000001
         10001111
11111111111111111
1001000W000000011
10100100000000001
11111111111111111
111111           


