F 000             , 001            ,          110   
C 255          , 255, 255
NO testNO
WE testEA
SO testSO
EA testWE

111111
10 1 1
101001
1100N1
111111
