F 100,1,110   

CSESA                  0 ,            94           ,            0,


WE testEA
SO testSO


NO testNO
EA testWE




111111111111                                                        
11110001111111
10000000000001
10000000000001
10000011111111
100S000001
1111111111