NO assets/textureNO.xpm

SO assets/textureSO.xpm

WE assets/textureWE.xpm

EA assets/textureEA.xpm

DO assets/door.xpm

F 235, 225, 250

C 255, 225, 200

        1111111111111111111111111
        1000000000110000000000001
        1D11000001110000000000001
        1001000000D00000000000001
111111111011000001110000000000001
10000000001100000111D111111111111
11110111111111D11100000010001
1111D111111111011101010010001
11000000110101011100000010001
100000000000000011000000D0001
10000000000000001101010010001
11000001110101011111011110N0111
11110111 1110101 101111010001
11111111 1111111 111111111111