NO assets/wrong_texture.xpm

SO assets/textureSO.xpm

WE assets/textureWE.xpm

EA assets/textureEA.xpm

F 235, 225, 250

C 255, 225, 200

11111111
10000001
10000001
10000001
1000W001
11111111