C 210, 235, 250 

F 179, 252, 206


WE assets/textureWE.xpm
SO assets/textureSO.xpm


NO assets/textureNO.xpm

EA assets/textureEA.xpm

   
   
11111111111111111111
1111000111000011111
1000000000000000011
100000000000011000111
10000011101100000111
1N0000000001111111
11111111111111111111