NO assets/textureNO.xpm

SO assets/textureSO.xpm

WE assets/textureWE.xpm

EA assets/textureEA.xpm

F 235, 225, 250

C 255, 225, 200

      1111111
1111111100001
1011000000001
10000000000E1
1111111111111