NO assets/textureNO.xpm

SO assets/textureSO.xpm

WE assets/textureWE.xpm

EA assets/textureEA.xpm

F 250, 215, 220

C 205, 230, 240

11111111111111111
10000000100000001
10000000100000001
10000000100000001
10000000100000001
10000000100000001
10000010101000001
10000000000000001
11111110N01111111
10000000000000001
10000010101000001
10000000100000001
10000000100000001
10000000100000001
10000000100000001
10000000100000001
11111111111111111
