F 0,0,110   

C           255 ,            255           ,           255   


WE textureNO.xpm
SO textureSO.xpm


NO textureNO.xpm
EA textureEA.xpm




11111111111111111111
1111000111000011111
1000000000000000011
100000000000011000111
10000011100000000111
1N0000000101111111
11111111111111111111