F 25, 100, 219  

C           255 ,            255           ,           255   


WE assets/textureNO.xpm
SO assets/textureSO.xpm


NO assets/textureNO.xpm
EA assets/textureEA.xpm




11111111111111111111
1111000111000011111
1000000000000000011
100000000000011000111
10000011101100000111
1N0000000001111111
11111111111111111111